1111111111111111111111
1E1000000000000C000C01
1010010100100000101001
1010010010101010001011
100000000C00C0000000P1
1111111111111111111111
