1111111111111111111111
1E1000000000000C000C01
10100101001N0000101001
101N010010101010001011
100000000C00C0000000P1
1111111111111111111111
