1111111111111
10C1000N000C1
100001000C001
1P000E0C000N1
1111111111111
1101101000111
1101101111N11
1110001000011
1111101011111
1111101100011
1111111111111
1111111111111
